  #######
  #     #
  # $ @ #
##### # #
# $     #
#  #$## ##
#..$  #  #
#..      #
##########