#######
#..   #
###$###
#$  @ #
#     #
#######