######
#..*.#
#.$  #
## $ #
##$ ##
#@$ #
##  #
 ####