 ##########
##    # @ ##
#  $.... $ #
# $ ####$  #
##  #  #   #
 ####  #####