#########
#.....  #
### $ # ##
  # $##  #
  #$ $ $ #
  #   #  #
  ##  # @#
   #######