#######
#..   #
#     #
###$###
# $ @ #
#     #
#######