   ####
####  #
# $...##
#@ $.. #
###$$$ #
  #    #
  ######