##########
#        #
#  $ $ $ #
#  . . . #
#  $ $ $ #
#  . . . #
#    @   #
##########