   #####
#### @ ###
#    #   #
# $$  #$ #
#  $#$ $ #
###...$###
 #.... #
 #######