########
#  @   #
#  #$$ #
## $  ##
 #  $.#
 ## .##
  #..#
  ####