###########
#@$       #
# ##### # #
# #   # # #
# # $ # # #
# # ### # #
# #     # #
# ####### #
#        .#
###########