#######
#@    #
#  $  #
#  .  #
#######