###########
#@$       #
# ##### # #
# #   # # #
# # $ # # #
# # ### # #
# #     # #
# # ##### #
#         #
#       ..#
###########