########
#      #
# .$@  #
#  .   #
# $    #
########