    #####
    #   #
    #$  #
  ### $ ###
  #  $  $ #
### # ### # #
#   # ### #####
# $      .. . #
###### ###  @ #
     #     ####
     #######