#############
#           #
# ######.## #
# # #   . # #
# #   # $ # #
# # ### ### #
# # *   *  @#
# #####$# ###
#         #
###########