#########
#   #   #
# $   $ #
#  ...  #
#   @   #
#########