##########
#        #
# $$  .. #
# $   .  #
#   @    #
#        #
##########