###########
##   #    #
#  $ . $  #
#  .@.    #
#  $ . $  #
##   #    #
###########