 ####
 #  #
 # $#
 #  #
## $#
#   #
# # ##
#  $.##
## *. #
 # #. #
 # ## #
 # ## #
 # @  #
 ######