############
#          #
# $$$  ... #
#          #
# ...  $$$ #
#    @     #
############