 ####
##  ##
#  $ ##
# #*  #
#  *  #
#  *  #
# #* ##
#@ . #
###  #
  ####