#######
#     #
### $ #
#  $  #
# @ . #
#   . #
#######